0030 0018 0018 0018 0018 0018 0018 0018 0018 0018 0018 0018 0018 0018 0018 0018 0018 0018 0031
0006 0022 0022 0023 0022 0022 0022 0023 0022 0022 0022 0022 0023 0022 0022 0022 0022 0022 0005
0009 0022 0023 0022 0024 0024 0023 0022 0022 0022 0022 0022 0022 0022 0022 0022 0022 0022 0008
0012 0022 0022 0022 0022 0000 0022 0022 0022 0022 0022 0022 0022 0022 0022 0022 0022 0022 0011
0009 0022 0022 0022 0022 0016 0022 0022 0022 0022 0022 0022 0022 0022 0022 0022 0022 0022 0008
0012 0022 0022 0022 0029 0022 0022 0022 0022 0022 0022 0022 0022 0022 0022 0022 0022 0022 0011
0009 0026 0027 0022 0022 0022 0022 0025 0022 0022 0022 0022 0022 0022 0022 0022 0022 0022 0008
0012 0028 0029 0022 0022 0022 0022 0024 0022 0022 0022 0022 0022 0022 0023 0022 0022 0022 0011
0009 0023 0022 0022 0022 0022 0022 0022 0022 0022 0022 0022 0022 0022 0022 0022 0022 0022 0008
0012 0022 0022 0022 0022 0022 0023 0022 0022 0022 0022 0022 0022 0022 0022 0022 0022 0022 0011
0009 0023 0022 0022 0022 0022 0022 0022 0022 0022 0022 0022 0022 0022 0022 0022 0022 0022 0008
0009 0022 0022 0022 0022 0022 0022 0022 0027 0022 0022 0022 0023 0022 0028 0022 0022 0022 0011
0009 0023 0022 0022 0022 0022 0022 0022 0022 0022 0022 0022 0022 0022 0022 0022 0022 0022 0008
0009 0022 0022 0022 0022 0022 0022 0022 0027 0022 0022 0022 0023 0022 0028 0022 0022 0022 0011
0033 0002 0002 0002 0002 0002 0002 0002 0002 0002 0002 0002 0002 0002 0002 0002 0002 0002 0032
